[bob.cli]
binseg = bob.ip.binseg.script.binseg:binseg

[bob.ip.binseg.cli]
compare = bob.bin.binseg.script.binseg:compare
gridtable = bob.ip.binseg.script.binseg:testcheckpoints
test = bob.ip.binseg.script.binseg:test
train = bob.ip.binseg.script.binseg:train
visualize = bob.ip.binseg.script.binseg:visualize

[bob.ip.binseg.config]
CHASEDB1 = bob.ip.binseg.configs.datasets.chasedb1
CHASEDB1TEST = bob.ip.binseg.configs.datasets.chasedb1test
COVD-CHASEDB1 = bob.ip.binseg.configs.datasets.drivestareiostarhrf960
COVD-CHASEDB1_SSL = bob.ip.binseg.configs.datasets.drivestareiostarhrf960sslchase
COVD-DRIVE = bob.ip.binseg.configs.datasets.starechasedb1iostarhrf544
COVD-DRIVE_SSL = bob.ip.binseg.configs.datasets.starechasedb1iostarhrf544ssldrive
COVD-HRF = bob.ip.binseg.configs.datasets.drivestarechasedb1iostar1168
COVD-HRF_SSL = bob.ip.binseg.configs.datasets.drivestarechasedb1iostar1168sslhrf
COVD-IOSTARVESSEL = bob.ip.binseg.configs.datasets.drivestarechasedb1hrf1024
COVD-IOSTARVESSEL_SSL = bob.ip.binseg.configs.datasets.drivestarechasedb1hrf1024ssliostar
COVD-STARE = bob.ip.binseg.configs.datasets.drivechasedb1iostarhrf608
COVD-STARE_SSL = bob.ip.binseg.configs.datasets.drivechasedb1iostarhrf608sslstare
DRIONSDB = bob.ip.binseg.configs.datasets.drionsdb
DRIONSDBTEST = bob.ip.binseg.configs.datasets.drionsdbtest
DRISHTIGS1CUP = bob.ip.binseg.configs.datasets.dristhigs1cup
DRISHTIGS1CUPTEST = bob.ip.binseg.configs.datasets.dristhigs1cuptest
DRISHTIGS1OD = bob.ip.binseg.configs.datasets.dristhigs1od
DRISHTIGS1ODTEST = bob.ip.binseg.configs.datasets.dristhigs1odtest
DRIU = bob.ip.binseg.configs.models.driu
DRIUBN = bob.ip.binseg.configs.models.driubn
DRIUBNSSL = bob.ip.binseg.configs.models.driubnssl
DRIUOD = bob.ip.binseg.configs.models.driuod
DRIUSSL = bob.ip.binseg.configs.models.driussl
DRIVE = bob.ip.binseg.configs.datasets.drive
DRIVETEST = bob.ip.binseg.configs.datasets.drivetest
HED = bob.ip.binseg.configs.models.hed
HRF = bob.ip.binseg.configs.datasets.hrf1168
HRFTEST = bob.ip.binseg.configs.datasets.hrftest
IMAGEFOLDER = bob.ip.binseg.configs.datasets.imagefolder
IOSTAROD = bob.ip.binseg.configs.datasets.iostarod
IOSTARODTEST = bob.ip.binseg.configs.datasets.iostarodtest
IOSTARVESSEL = bob.ip.binseg.configs.datasets.iostarvessel
IOSTARVESSELTEST = bob.ip.binseg.configs.datasets.iostarvesseltest
M2UNet = bob.ip.binseg.configs.models.m2unet
M2UNetSSL = bob.ip.binseg.configs.models.m2unetssl
REFUGECUP = bob.ip.binseg.configs.datasets.refugecup
REFUGECUPTEST = bob.ip.binseg.configs.datasets.refugecuptest
REFUGEOD = bob.ip.binseg.configs.datasets.refugeod
REFUGEODTEST = bob.ip.binseg.configs.datasets.refugeodtest
RIMONER3CUP = bob.ip.binseg.configs.datasets.rimoner3cup
RIMONER3CUPTEST = bob.ip.binseg.configs.datasets.rimoner3cuptest
RIMONER3OD = bob.ip.binseg.configs.datasets.rimoner3od
RIMONER3ODTEST = bob.ip.binseg.configs.datasets.rimoner3odtest
ResUNet = bob.ip.binseg.configs.models.resunet
STARE = bob.ip.binseg.configs.datasets.stare
STARETEST = bob.ip.binseg.configs.datasets.staretest
UNet = bob.ip.binseg.configs.models.unet

