[console_scripts]
boobands = weboob.applications.boobands:Boobands.run
boobank = weboob.applications.boobank:Boobank.run
boobathon = weboob.applications.boobathon:Boobathon.run
boobcoming = weboob.applications.boobcoming:Boobcoming.run
boobill = weboob.applications.boobill:Boobill.run
booblyrics = weboob.applications.booblyrics:Booblyrics.run
boobmsg = weboob.applications.boobmsg:Boobmsg.run
boobooks = weboob.applications.boobooks:Boobooks.run
boobsize = weboob.applications.boobsize:Boobsize.run
boobtracker = weboob.applications.boobtracker:BoobTracker.run
boomoney = weboob.applications.boomoney:Boomoney.run
cineoob = weboob.applications.cineoob:Cineoob.run
comparoob = weboob.applications.comparoob:Comparoob.run
cookboob = weboob.applications.cookboob:Cookboob.run
flatboob = weboob.applications.flatboob:Flatboob.run
galleroob = weboob.applications.galleroob:Galleroob.run
geolooc = weboob.applications.geolooc:Geolooc.run
handjoob = weboob.applications.handjoob:Handjoob.run
havedate = weboob.applications.havedate:HaveDate.run
monboob = weboob.applications.monboob:Monboob.run
parceloob = weboob.applications.parceloob:Parceloob.run
pastoob = weboob.applications.pastoob:Pastoob.run
radioob = weboob.applications.radioob:Radioob.run
shopoob = weboob.applications.shopoob:Shopoob.run
suboob = weboob.applications.suboob:Suboob.run
translaboob = weboob.applications.translaboob:Translaboob.run
traveloob = weboob.applications.traveloob:Traveloob.run
videoob = weboob.applications.videoob:Videoob.run
webcontentedit = weboob.applications.webcontentedit:WebContentEdit.run
weboob = weboob.applications.weboobmain:WeboobMain.run
weboob-cli = weboob.applications.weboobcli:WeboobCli.run
weboob-config = weboob.applications.weboobcfg:WeboobCfg.run
weboob-debug = weboob.applications.weboobdebug:WeboobDebug.run
weboob-repos = weboob.applications.weboobrepos:WeboobRepos.run
weboorrents = weboob.applications.weboorrents:Weboorrents.run
wetboobs = weboob.applications.wetboobs:WetBoobs.run

